NO ./textures/north.xpm
SO ./textures/south.xpm
EA ./textures/west.xpm
WE ./textures/east.xpm

F 100,100,100
C 200,200,255

1111111
1000001
100E001
1000001
1111111