NO ./textures/north.xpm
SO ./textures/south.xpm
EA ./textures/east.xpm
WE ./textures/west.xpm

F 100,100,100
C 200,200,255

111111
100001
1000N1
100001
111111