NO ./textures/north.xpm
SO ./textures/south.xpm
EA ./textures/east.xpm
WE ./textures/west.xpm
C 112,141,35
F 135,89,26

1111111111111111111111
1000000000000000000001
1000000000100000000001
1000000000100000000001
1000000111111100000001
1000000000100000000001
1000000000100000000001
100000N000000000000001
1111111111111111111111
